      NO textures/wood_strips.xpm

C 97, 85, 127
SO textures/wood.xpm



WE textures/wood_box.xpm

F 90        ,     90 ,      90

EA                textures/rocks.xpm

      1111111               1111111111111111111
      1000001               10000000000000000001 1111111111
      100S001      1111111111000000000000000000111000000001
      1110111      1000000110000000000000000000000000000001
        101        1000000000000000000000000000111000000001
1111111100011111  1110111111111111110111111111111 1111111111
1000001100000000110000001          101
1000000000000000000000001 11111111110111111111111
1000001100000000110000001 10000000000000000000001
1110111100000000110000001 10000000000000000000001
1000001 11111111111111111 10000000000000000000001
1000001 10000000000001    10000000000000000000001
1000001110000000000001    10000000000000000000001
1000000000000000000001    10000000000000000000001
1000001110000000000001    10000000000000000000001
1000001 10000000000001    10000000000000000000001
1000001 11111111111111    10000000000000000000001
1000001                   10000000000000000000001
1000001                   10000000000000000000001
1000001                   10000000000000000000001
1000001                   11111111111111111111111
1000001
10000011111111111111111111111111111111111
10000011000000000000001100000001100000001
10000000000000000000000000000000000000001
10000011000000000000001100000001100000001
11111111111111111111111111111111111111111