NO src/assets/textures/creeper.xpm
SO src/assets/textures/portal.xpm
WE src/assets/textures/axe.xpm
EA src/assets/textures/tree.xpm

F 38,70,83
C 244,162,97

111111111111111111
100000000000000101
100100000000000101
111000000000010101
100000000000010101
100000000000000101
1000000N0000000001
100000000000000001
111100010000011101
100000000000000001
111111111111111111