SO           textures/wood_strips.xpm 
     
NO           textures/wood.xpm
EA           textures/rocks.xpm       
WE           textures/wood_box.xpm  


F 255, 255 ,255

C 0, 0 ,0

1111111111111111111111111
1000000000110000000000001
1011000001110000000N00001
10010000000000000000000001
1111111111111111111111111