NO    src/assets/textures/red_brick.xpm
SO src/assets/textures/  grand_theft_auto_san_.xpm
WE src/assets/textures/brick_purple.xpm
EA src/assets/textures/glowing_wall.xpm

                 F 38    ,    250   ,     83
C 244,162,97


1111111        1111111111111111111
111111111111111
100000000000101
100101000000101
111110000010101
100000000010101
111111111111111
111111111111111
1000000N0000101
100000000000001
100000000000001
111111000111101
100000000000001
111111111111111