NO textures/wood_strips.xpm
SO textures/wood.xpm

F 100,100,0
C     250,154,8

WE textures/wood_box.xpm
EA textures/rocks.xpm

        11111111111 1111111111111
        1000000000110000000000001
        1011000001110000000000001
        1001000000000000000000001
1111111110110000011100000000000001
10000000011000001110111100011111
11110111111111011100000010001
11110111111111011101010010001
11000000110101011100011110001
10000000000000001100000010001
10000000000000001101010010N01
1100000111010101111101111000111
11110111 1110101 101111010001
11111111 1111111 111111111111
