NO    src/assets/textures/planks.xpm
SO src/assets/textures/rock.xpm
WE src/assets/textures/rock.xpm
EA src/assets/textures/planks.xpm

 F 3, 36, 21
C 21, 47, 89


11111111111111111111111
10000000000000000000101
10010101010101000000101
11111111100000000010101
10000000000000000010101
11000000000000011111111
1000000000N000000000101
10000000000000000000001
10000000000000000000001
11111101110111000111101
10000000000000000000001
11111111111111111111111