SO           textures/wood_strips.xpm 
     
NO           textures/wood.xpm
EA           textures/rocks.xpm       
WE           textures/wood_box.xpm  


F 255,255 ,255

C 0, 0 ,0

111111111111111
100000000000101
100101000000101
111110000010101
100000000010101
1000000N0000101
100000000000001
100000000000001
111111000111101
100000000000001
111111111111111