NO src/assets/textures/red_brick.xpm
SO src/assets/textures/red_brick.xpm
WE src/assets/textures/red_brick.xpm
EA src/assets/textures/red_brick.xpm

F 147,183,190
C     250,154,8

111111111111111
100000000000101
100101000000101
111110000010101
100000000010101
1000000S0000101
100000000000001
100000000000001
111111000111101
100000000000001
111111111111111